5
5 5 5
9 9 9 9 9
9 8 0 0 9
9 0 0 0 9
9 0 0 7 9
9 9 9 9 9
8 8 6
9 9 9 9 9 9 9 9
9 8 0 1 0 0 0 9
9 0 0 2 0 0 0 9
9 0 0 3 0 0 0 9
9 0 0 1 0 0 0 9
9 0 0 2 0 0 0 9
9 0 0 0 0 0 7 9
9 9 9 9 9 9 9 9
10 10 10
9 9 9 9 9 9 9 9 9 9
9 8 0 0 0 0 0 0 0 9
9 0 0 6 0 0 0 0 0 9
9 0 0 0 0 0 6 0 0 9
9 0 0 0 0 0 0 0 0 9
9 0 0 0 0 0 0 0 5 9
9 0 0 5 0 0 0 0 0 9
9 0 0 0 0 0 0 0 0 9
9 5 0 0 0 0 0 0 7 9
9 9 9 9 9 9 9 9 9 9
10 10 10
9 9 9 9 9 9 9 9 9 9
9 8 0 0 1 0 0 1 0 9
9 0 0 0 1 0 0 1 0 9
9 0 0 0 1 0 6 1 0 9
9 0 0 0 1 0 0 1 0 9
9 0 0 0 0 0 0 1 0 9
9 0 0 2 2 2 2 1 0 9
9 0 0 0 0 0 0 0 0 9
9 0 0 0 0 0 0 0 7 9
9 9 9 9 9 9 9 9 9 9
10 5 10
9 9 9 9 9 9 9 9 9 9
9 8 0 0 0 0 0 0 0 9
9 0 0 0 0 0 0 0 0 9
9 0 0 0 0 0 0 0 7 9
9 9 9 9 9 9 9 9 9 9