3
5 5 30
9 9 9 9 9
9 8 0 0 9
9 0 0 0 9
9 0 0 7 9
9 9 9 9 9
4 4 30
0 0 0 0
0 0 0 0
0 0 0 0
0 0 0 0
10 10 30
9 9 9 9 9 9 9 9 9 9
9 8 0 0 0 0 0 0 0 9
9 0 0 0 0 0 0 0 0 9
9 0 0 0 0 0 0 0 0 9
9 0 0 0 0 0 0 0 0 9
9 0 0 0 0 0 0 0 0 9
9 0 0 0 0 0 0 0 0 9
9 0 0 0 0 0 0 0 0 9
9 0 0 0 0 0 0 0 7 9
9 9 9 9 9 9 9 9 9 9