12
10 10 10 5
9 9 9 9 9 9 9 9 9 9
9 8 0 0 1 0 0 1 0 9
9 0 0 0 1 0 0 1 0 9
9 0 0 0 1 0 6 1 0 9
9 0 0 5 1 0 0 1 0 9
9 0 0 0 0 0 0 1 0 9
9 0 0 2 2 2 2 1 0 9
9 0 0 0 0 0 0 0 0 9
9 0 0 4 0 0 4 0 7 9
9 9 9 9 9 9 9 9 9 9
30 30 20 5
9 9 9 9 9 9 9 9 9 9 9 9 9 9 9 9 9 9 9 9 9 9 9 9 9 9 9 9 9 9
9 8 0 2 0 0 0 0 0 0 2 0 0 0 0 0 0 0 0 0 0 0 0 0 0 0 0 0 0 9
9 0 0 2 0 0 0 0 0 0 3 0 0 0 0 0 0 0 0 0 0 0 0 0 0 0 0 0 0 9
9 0 0 3 2 1 0 0 0 0 2 0 0 0 0 0 0 0 0 0 0 0 0 0 0 0 0 0 0 9
9 0 0 3 1 1 0 2 1 0 3 0 0 0 0 0 0 0 0 0 0 0 0 0 0 0 0 0 0 9
9 0 0 0 0 0 2 2 1 0 2 0 0 0 0 0 0 0 0 0 0 0 0 0 0 0 0 0 0 9
9 0 0 0 0 0 0 1 1 0 3 0 0 0 0 0 5 0 0 0 0 0 0 0 0 0 0 0 0 9
9 0 0 0 0 0 0 1 4 4 2 0 0 0 0 5 0 5 0 0 0 0 0 0 0 0 0 0 0 9
9 0 0 0 0 0 0 1 4 0 0 0 0 0 0 0 0 0 5 0 0 0 0 0 0 0 0 0 0 9
9 0 0 0 0 2 2 3 3 0 0 0 0 0 0 0 0 0 0 0 0 0 0 0 0 0 0 0 0 9
9 0 0 0 0 2 0 0 3 3 0 0 0 0 0 0 0 0 0 6 0 0 0 0 0 0 0 0 0 9
9 0 0 0 0 3 0 0 3 0 3 0 0 0 0 0 0 0 0 0 0 0 0 0 0 0 0 0 0 9
9 6 0 0 0 2 0 0 3 0 0 3 0 0 0 0 0 0 0 0 6 0 0 0 0 0 0 0 0 9
9 0 0 0 0 3 0 0 3 0 0 0 3 0 0 0 0 0 0 0 0 0 0 0 0 0 0 0 0 9
9 0 0 0 0 2 0 0 3 3 3 3 3 3 0 0 0 0 0 0 2 1 2 1 2 1 2 1 2 9
9 0 0 0 0 3 0 0 0 0 0 0 2 0 0 0 0 0 0 0 1 0 5 0 0 0 0 0 0 9
9 0 6 0 0 2 0 0 2 0 0 0 2 0 0 0 0 0 0 0 2 0 5 0 0 0 0 0 0 9
9 0 0 0 0 3 0 3 5 0 0 0 2 0 0 0 0 0 0 0 1 0 5 0 0 0 0 0 0 9
9 0 0 0 0 2 0 0 2 0 0 0 2 0 0 0 0 0 0 0 2 0 5 0 0 0 0 0 0 9
9 0 0 0 0 3 0 0 2 0 0 0 2 0 0 0 0 0 0 0 1 0 5 0 0 0 0 0 0 9
9 0 0 0 0 2 0 3 5 0 0 0 2 0 0 0 0 0 0 0 2 0 5 0 0 0 0 0 0 9
9 0 0 0 0 3 0 3 5 0 0 0 2 0 0 0 0 0 0 0 1 6 5 0 0 0 0 0 0 9
9 0 0 6 0 2 0 0 2 0 0 0 2 0 0 0 0 0 0 0 2 6 5 0 0 0 0 0 0 9
9 0 0 0 0 3 0 3 6 0 0 0 2 0 0 0 0 0 0 0 1 6 5 0 0 0 0 0 0 9
9 0 0 0 0 2 0 0 2 0 0 0 2 0 0 0 0 0 0 0 2 6 5 0 0 0 0 0 0 9
9 0 0 0 0 3 0 3 6 0 0 0 2 0 0 0 0 0 0 0 1 6 5 0 0 0 0 0 0 9
9 0 0 0 0 2 0 0 2 0 0 0 2 0 0 0 0 0 0 0 2 6 5 0 0 0 0 0 0 9
9 0 0 0 0 3 0 3 6 0 0 0 2 0 0 0 0 0 0 0 1 6 5 0 0 0 0 4 4 9
9 0 0 0 6 2 0 0 2 0 0 0 2 0 0 0 0 0 0 0 2 6 5 0 0 0 0 4 7 9
9 9 9 9 9 9 9 9 9 9 9 9 9 9 9 9 9 9 9 9 9 9 9 9 9 9 9 9 9 9
30 30 25 5
9 9 9 9 9 9 9 9 9 9 9 9 9 9 9 9 9 9 9 9 9 9 9 9 9 9 9 9 9 9
9 8 0 0 0 0 0 0 0 0 0 0 0 0 3 3 5 0 0 0 5 3 5 0 0 0 0 0 0 9
9 0 0 0 0 1 0 0 0 0 0 0 0 0 3 3 5 0 0 0 2 4 2 0 0 0 0 0 0 9
9 0 0 0 0 3 0 0 0 0 0 0 0 0 3 3 5 0 0 0 2 4 2 0 0 0 0 0 0 9
9 0 0 0 0 3 0 0 0 0 0 0 0 0 3 3 5 0 0 0 2 4 2 0 0 0 0 0 0 9
9 0 0 0 0 9 0 0 5 0 0 0 0 0 3 3 5 0 0 0 5 3 5 0 0 0 0 0 0 9
9 0 0 0 0 9 0 0 0 0 0 0 4 0 3 3 0 4 0 0 0 0 0 0 0 0 0 0 0 9
9 0 0 0 0 9 0 5 0 0 0 0 3 0 3 3 0 3 0 0 0 0 0 0 0 3 2 1 0 9
9 0 0 0 0 9 0 0 0 0 0 0 3 0 3 3 0 3 0 0 0 0 0 0 0 1 2 3 0 9
9 0 0 0 0 9 0 0 0 0 0 0 3 0 3 3 0 3 0 0 0 0 0 0 0 3 1 2 0 9
9 0 0 0 0 9 0 0 0 0 0 0 3 0 3 3 0 3 0 0 0 0 0 0 0 1 3 2 0 9
9 6 6 6 6 9 5 0 0 0 0 0 3 0 3 3 0 3 0 0 0 0 0 0 0 0 4 0 0 9
9 9 3 3 9 9 0 0 0 0 4 0 3 0 3 3 0 3 0 4 0 0 0 0 0 0 6 0 0 9
9 0 0 0 0 0 0 0 0 0 3 0 3 0 3 3 0 3 0 3 0 0 0 0 0 0 4 0 0 9
9 0 0 0 0 0 0 0 0 0 3 0 3 0 3 3 0 3 0 3 0 0 0 0 0 0 6 0 0 9
9 0 0 0 0 5 0 0 0 0 3 0 3 0 3 3 0 3 0 3 0 0 0 0 0 0 4 0 0 9
9 0 0 0 0 0 0 0 0 0 3 0 3 0 3 3 0 3 0 3 0 0 0 0 0 0 6 0 0 9
9 0 0 0 5 0 0 0 4 0 3 0 3 0 3 3 0 3 0 3 0 4 0 0 0 0 0 0 0 9
9 0 0 0 0 0 0 0 3 0 3 0 3 0 3 3 4 3 0 3 0 3 0 0 0 4 0 0 0 9
9 0 5 0 0 0 0 0 3 0 3 0 3 0 3 3 0 3 0 3 0 3 0 0 0 0 0 0 0 9
9 0 0 0 0 0 0 0 3 0 3 0 3 0 3 3 0 3 0 3 0 3 0 0 0 0 0 0 0 9
9 0 0 0 0 0 4 0 3 0 3 0 3 0 3 3 0 3 0 3 5 3 0 4 0 0 4 0 0 9
9 0 0 0 0 0 3 0 3 0 3 0 3 0 3 3 0 3 0 3 0 3 0 3 0 0 0 0 0 9
9 0 0 0 0 0 3 0 3 0 3 0 3 0 3 3 4 3 0 3 0 3 0 3 0 0 0 0 0 9
9 0 0 0 4 0 3 0 3 0 3 0 3 0 3 3 0 3 0 3 0 3 6 3 0 4 0 0 0 9
9 0 0 0 3 0 3 0 3 0 3 0 3 0 3 3 0 3 0 3 0 3 0 3 0 3 0 0 0 9
9 0 3 0 3 0 3 0 3 0 3 0 3 0 3 3 0 3 0 3 0 3 0 3 0 3 4 3 3 9
9 0 3 0 3 0 3 0 3 0 3 0 3 0 3 3 0 3 0 3 0 3 0 3 5 3 0 3 4 9
9 0 3 0 3 0 3 0 3 0 3 0 3 0 3 3 0 3 6 3 0 3 0 3 0 3 4 3 7 9
9 9 9 9 9 9 9 9 9 9 9 9 9 9 9 9 9 9 9 9 9 9 9 9 9 9 9 9 9 9
30 30 30 5
9 9 9 9 9 9 9 9 9 9 9 9 9 9 9 9 9 9 9 9 9 9 9 9 9 9 9 9 9 9
9 8 9 9 9 9 9 9 9 9 9 9 9 9 9 9 9 9 9 9 9 9 9 9 9 9 9 9 0 9
9 0 0 0 0 0 0 0 0 0 0 0 0 0 0 0 0 0 0 0 0 0 0 0 0 0 0 0 0 9
9 0 0 0 0 0 0 0 0 0 0 0 0 0 0 0 0 0 0 0 0 0 0 0 0 0 0 0 0 9
9 0 5 0 0 0 0 0 0 0 5 0 0 0 0 0 0 0 5 0 0 0 0 0 0 0 5 0 0 9
9 6 2 6 0 0 0 0 0 6 2 6 0 0 0 0 0 6 2 6 0 0 0 0 0 6 2 6 0 9
9 2 0 2 6 0 0 0 6 2 0 2 6 0 0 0 6 2 0 2 6 0 0 0 6 2 0 2 6 9
9 0 0 0 2 6 0 6 2 0 0 0 2 6 0 6 2 0 0 0 2 6 0 6 2 0 0 0 2 9
9 0 0 0 0 2 6 2 0 0 0 0 0 2 6 2 0 0 0 0 0 2 6 2 0 0 0 0 0 9
9 0 0 0 0 0 2 0 0 0 0 0 0 0 2 0 0 0 0 0 0 0 2 0 0 0 0 0 0 9
9 0 5 0 0 0 0 0 0 0 5 0 0 0 0 0 0 0 5 0 0 0 0 0 0 0 5 0 0 9
9 6 2 6 0 0 0 0 0 6 2 6 0 0 0 0 0 6 2 6 0 0 0 0 0 6 2 6 0 9
9 2 0 2 6 0 0 0 6 2 0 2 6 0 0 0 6 2 0 2 6 0 0 0 6 2 0 2 6 9
9 0 0 0 2 6 0 6 2 0 0 0 2 6 0 6 2 0 0 0 2 6 0 6 2 0 0 0 2 9
9 0 0 0 0 2 6 2 0 0 0 0 0 2 6 2 0 0 0 0 0 2 6 2 0 0 0 0 0 9
9 0 0 0 0 0 2 0 0 0 0 0 0 0 2 0 0 0 0 0 0 0 2 0 0 0 0 0 0 9
9 0 5 0 0 0 0 0 0 0 5 0 0 0 0 0 0 0 5 0 0 0 0 0 0 0 5 0 0 9
9 6 2 6 0 0 0 0 0 6 2 6 0 0 0 0 0 6 2 6 0 0 0 0 0 6 2 6 0 9
9 2 0 2 6 0 0 0 6 2 0 2 6 0 0 0 6 2 0 2 6 0 0 0 6 2 0 2 6 9
9 0 0 0 2 6 0 6 2 0 0 0 2 6 0 6 2 0 0 0 2 6 0 6 2 0 0 0 2 9
9 0 0 0 0 2 6 2 0 0 0 0 0 2 6 2 0 0 0 0 0 2 6 2 0 0 0 0 0 9
9 0 0 0 0 0 2 0 0 0 0 0 0 0 2 0 0 0 0 0 0 0 2 0 0 0 0 0 0 9
9 0 5 0 0 0 0 0 0 0 5 0 0 0 0 0 0 0 5 0 0 0 0 0 0 0 5 0 0 9
9 6 2 6 0 0 0 0 0 6 2 6 0 0 0 0 0 6 2 6 0 0 0 0 0 6 2 6 0 9
9 2 0 2 6 0 0 0 6 2 0 2 6 0 0 0 6 2 0 2 6 0 0 0 6 2 0 2 6 9
9 0 0 0 2 6 0 6 2 0 0 0 2 6 0 6 2 0 0 0 2 6 0 6 2 0 0 0 2 9
9 0 0 0 0 2 6 2 0 0 0 0 0 2 6 2 0 0 0 0 0 2 6 2 0 0 0 0 0 9
9 0 0 0 0 0 2 0 0 0 0 0 0 0 2 0 0 0 0 0 0 0 2 0 0 0 0 1 1 9
9 0 0 0 0 0 0 0 0 0 0 0 0 0 0 0 0 0 0 0 0 0 0 0 5 0 0 1 7 9
9 9 9 9 9 9 9 9 9 9 9 9 9 9 9 9 9 9 9 9 9 9 9 9 9 9 9 9 9 9
30 30 30 5
9 9 9 9 9 9 9 9 9 9 9 9 9 9 9 9 9 9 9 9 9 9 9 9 9 9 9 9 9 9
9 8 0 0 0 0 0 0 6 6 3 6 4 0 1 0 0 0 0 0 0 0 0 0 0 0 0 0 0 9
9 0 0 0 0 0 0 3 6 6 3 6 4 1 5 1 0 0 0 0 0 0 0 0 0 0 0 0 0 9
9 0 0 0 0 0 0 3 3 3 3 3 9 0 1 3 3 0 0 0 0 0 0 3 3 0 0 0 0 9
9 0 0 0 0 0 0 0 0 0 0 0 9 0 3 6 6 3 0 0 0 0 3 6 6 3 0 0 0 9
9 0 0 0 0 0 0 0 0 0 0 0 9 0 3 6 6 3 0 0 0 0 3 6 6 3 0 0 0 9
9 0 0 0 0 0 0 0 0 0 0 5 4 0 0 3 3 0 0 0 0 0 0 3 3 0 0 0 0 9
9 0 0 0 0 0 0 0 0 0 0 0 9 0 0 0 0 0 0 0 0 2 2 0 0 0 0 0 0 9
9 2 0 9 0 9 0 9 0 9 0 0 9 0 1 0 0 0 0 0 2 5 5 2 0 0 0 0 0 9
9 0 0 0 1 0 0 0 0 0 0 0 9 1 0 1 0 3 3 0 2 5 5 2 0 0 0 0 0 9
9 0 0 1 5 1 0 6 0 0 0 5 4 0 5 0 3 6 6 3 0 2 2 0 0 3 3 0 0 9
9 0 0 0 1 0 0 0 0 0 0 0 9 0 0 0 3 6 6 3 0 0 0 0 3 6 6 3 0 9
9 0 0 0 0 0 0 0 0 0 0 0 9 0 0 0 0 3 3 0 0 0 0 0 3 6 6 3 0 9
9 0 0 6 0 0 0 0 0 0 0 5 9 0 0 3 2 0 0 0 0 0 0 2 2 3 3 0 0 9
9 0 0 0 0 0 0 0 0 0 5 1 4 0 2 6 5 3 0 0 0 0 2 5 6 2 0 0 0 9
9 0 0 0 0 0 0 0 0 0 0 5 9 0 3 6 5 2 0 0 3 3 2 5 6 2 0 1 1 9
9 2 0 9 0 9 0 9 0 9 0 0 9 0 1 2 3 0 0 3 6 6 3 2 2 0 1 5 5 9
9 0 1 0 0 0 0 0 0 0 0 0 9 1 5 1 0 0 0 3 6 6 3 0 0 0 1 5 5 9
9 1 5 1 0 0 0 0 0 6 0 5 4 0 1 0 2 2 0 4 3 3 0 0 0 0 0 1 1 9
9 0 1 0 0 0 1 0 0 0 0 0 9 0 0 2 6 5 2 0 0 4 0 0 3 3 0 0 0 9
9 0 0 0 0 1 5 1 0 0 0 0 9 0 0 2 5 6 2 0 0 1 1 3 6 6 3 0 0 9
9 0 0 0 0 0 1 0 0 0 0 0 9 0 0 0 2 2 0 0 1 5 1 3 6 6 3 0 0 9
9 2 0 9 0 9 0 9 0 9 0 5 4 0 0 0 0 0 0 0 0 1 0 0 3 3 0 0 0 9
9 0 0 0 0 0 0 0 0 0 0 0 9 0 6 6 0 0 2 2 2 2 2 2 2 2 2 0 0 9
9 2 6 5 6 5 6 5 6 5 0 0 9 0 0 0 0 2 6 5 6 5 6 5 6 5 6 2 0 9
9 0 0 0 0 0 0 0 0 0 0 5 9 0 0 0 0 2 0 0 0 0 0 0 0 0 0 2 0 9
9 0 0 0 0 0 0 0 0 0 5 1 4 0 0 0 0 2 0 9 0 9 0 9 0 9 0 2 0 9
9 0 0 0 0 0 0 0 0 0 0 5 9 0 6 6 0 0 2 2 2 2 2 2 2 2 2 0 0 9
9 2 6 5 6 5 6 5 6 5 0 0 9 0 0 0 0 0 2 0 1 1 4 4 4 6 2 0 7 9
9 9 9 9 9 9 9 9 9 9 9 9 9 9 9 9 9 9 9 9 9 9 9 9 9 9 9 9 9 9
30 30 20 5
9 9 9 9 9 9 9 9 9 9 9 9 9 9 9 9 9 9 9 9 9 9 9 9 9 9 9 9 9 9
9 8 0 1 6 1 0 0 0 0 0 0 0 0 0 0 0 0 0 0 0 0 0 0 0 0 0 0 0 9
9 0 0 0 1 6 1 0 0 0 0 0 0 0 0 0 0 0 0 0 0 0 0 0 0 0 0 0 0 9
9 1 0 0 0 1 6 1 0 0 0 0 0 0 0 0 0 0 0 0 0 0 0 0 0 0 0 0 0 9
9 6 1 0 0 0 1 6 1 0 0 0 0 0 0 0 0 0 0 0 0 0 0 0 0 0 0 0 0 9
9 1 6 1 0 4 0 1 6 1 0 0 0 0 0 0 0 0 0 0 0 0 0 0 0 0 0 0 0 9
9 0 1 6 1 0 0 0 1 6 1 0 0 0 0 0 0 0 0 0 0 0 0 0 0 0 0 0 0 9
9 0 0 1 6 1 0 0 0 1 6 1 0 0 0 0 0 0 0 0 0 0 0 0 0 0 0 0 0 9
9 0 0 0 1 6 1 0 0 0 1 6 1 0 0 0 0 0 0 0 0 0 0 0 0 0 0 0 0 9
9 0 0 0 0 1 6 1 0 4 0 1 6 1 0 0 0 0 0 0 0 0 0 0 0 0 0 0 0 9
9 0 0 0 0 0 1 6 1 0 0 0 1 6 1 0 0 0 0 0 0 0 0 0 0 0 0 0 0 9
9 0 0 0 0 0 0 1 6 1 0 0 0 1 6 1 0 0 0 0 0 0 0 0 0 0 0 0 0 9
9 0 0 0 0 0 0 0 1 6 1 0 0 0 1 6 1 0 0 0 0 0 0 0 0 0 0 0 0 9
9 0 0 0 0 0 0 0 0 1 6 1 0 4 0 1 6 1 0 0 0 0 0 0 0 0 0 0 0 9
9 0 0 0 0 0 0 0 0 0 1 6 1 0 0 0 1 6 1 0 0 0 0 0 0 0 0 0 0 9
9 0 0 0 0 0 0 0 0 0 0 1 6 1 0 0 0 1 6 1 0 0 0 0 0 0 0 0 0 9
9 0 0 0 0 0 0 0 0 0 0 0 1 6 1 0 0 0 1 6 1 0 0 0 0 0 0 0 0 9
9 0 0 0 0 0 0 0 0 0 0 0 0 1 6 1 0 4 0 1 6 1 0 0 0 0 0 0 0 9
9 0 0 0 0 0 0 0 0 0 0 0 0 0 1 6 1 0 0 0 1 6 1 0 0 0 0 0 0 9
9 0 0 0 0 0 0 0 0 0 0 0 0 0 0 1 6 1 0 0 0 1 6 1 1 1 1 1 1 9
9 0 0 0 0 0 0 0 0 0 0 0 0 0 0 0 1 6 1 0 0 0 1 6 1 6 6 6 6 9
9 0 0 0 0 0 0 0 0 0 0 0 0 0 0 0 0 1 6 1 0 4 0 1 6 6 6 6 6 9
9 0 0 0 0 0 0 0 0 0 0 0 0 0 0 0 0 0 1 6 1 0 0 0 1 6 6 6 6 9
9 0 0 0 0 0 0 0 0 0 0 0 0 0 0 0 0 0 0 1 6 1 0 0 0 1 6 6 6 9
9 0 0 0 0 0 0 0 0 0 0 0 0 0 0 0 0 0 0 1 1 6 1 0 0 0 1 6 6 9
9 0 0 0 0 0 0 0 0 0 0 0 0 0 0 0 0 0 0 1 6 6 6 1 0 4 0 1 0 9
9 0 0 0 0 0 0 0 0 0 0 0 0 0 0 0 0 0 0 1 6 6 6 6 1 0 0 0 0 9
9 0 0 0 0 0 0 0 0 0 0 0 0 0 0 0 0 0 0 1 6 6 6 6 6 1 0 0 0 9
9 0 0 0 0 0 0 0 0 0 0 0 0 0 0 0 0 0 0 1 6 6 6 6 6 0 0 0 7 9
9 9 9 9 9 9 9 9 9 9 9 9 9 9 9 9 9 9 9 9 9 9 9 9 9 9 9 9 9 9
30 30 25 5
9 9 9 9 9 9 9 9 9 9 9 9 9 9 9 9 9 9 9 9 9 9 9 9 9 9 9 9 9 9
9 0 0 0 0 0 0 5 0 6 0 4 0 4 5 6 4 5 6 4 5 6 9 0 9 9 9 9 0 9
9 0 5 0 0 0 0 0 0 2 2 2 2 2 2 2 0 0 0 5 6 5 6 5 6 5 6 5 6 9
9 0 5 0 0 0 0 2 2 2 2 2 2 0 0 0 2 2 0 0 0 0 0 9 0 0 0 0 0 9
9 0 6 0 0 0 2 0 0 5 6 0 0 2 2 0 0 0 2 0 0 0 0 9 0 0 0 0 0 9
9 0 5 0 0 2 8 2 2 2 2 0 5 0 6 2 0 0 0 2 0 0 0 9 0 0 0 0 0 9
9 0 6 0 0 2 2 0 0 5 0 2 2 0 0 0 2 0 0 2 0 0 0 4 0 0 0 0 0 9
9 0 5 0 0 0 2 0 0 0 0 0 0 2 5 6 0 2 0 2 0 0 0 9 0 0 0 0 0 9
9 0 6 0 0 2 0 2 2 2 0 0 0 0 2 0 0 2 0 2 0 0 0 9 0 0 0 0 0 9
9 0 5 0 0 2 2 4 4 4 2 0 9 0 2 2 0 0 2 2 2 0 0 9 0 0 0 0 0 9
9 0 5 0 0 2 2 4 4 4 2 0 0 0 2 0 2 0 2 4 4 2 0 0 0 0 0 0 0 9
9 0 5 0 2 0 2 4 4 4 2 0 0 2 5 6 2 0 2 4 4 2 0 0 0 0 0 0 0 9
9 0 6 2 0 0 0 2 2 2 0 2 2 0 0 0 2 2 0 2 2 0 0 0 0 0 0 0 0 9
9 0 5 2 0 0 0 0 0 0 0 0 0 0 2 2 0 2 0 0 0 0 0 0 0 0 0 0 0 9
9 0 2 2 0 0 0 0 0 0 0 0 0 0 2 0 2 2 0 0 0 0 0 0 0 0 0 0 0 9
9 2 0 0 2 0 0 0 0 0 0 0 0 2 0 2 0 0 2 0 0 0 0 0 3 3 3 3 0 9
9 2 0 0 2 2 0 0 0 0 2 2 2 0 2 0 5 0 0 2 0 0 0 3 0 0 0 0 3 9
9 0 2 2 0 2 2 2 2 2 0 0 2 2 0 0 0 0 0 2 0 0 3 0 0 0 0 0 0 9
9 0 0 2 2 0 2 0 0 2 0 5 0 0 5 6 2 0 2 0 2 3 0 0 6 0 6 0 0 9
9 0 6 0 2 0 0 2 2 0 0 0 0 0 0 2 0 2 0 0 2 0 0 0 0 6 0 0 0 9
9 0 0 2 0 2 0 0 2 2 2 2 0 0 0 2 0 0 2 2 0 0 0 0 6 0 6 0 0 9
9 0 0 2 2 0 2 2 0 5 5 6 2 2 0 2 0 0 3 0 0 0 0 0 0 0 0 0 0 9
9 0 5 0 2 2 0 0 2 2 2 2 0 0 2 2 0 3 0 0 6 0 6 0 0 0 0 0 0 9
9 0 0 0 2 0 2 2 0 0 2 2 2 2 0 2 3 0 0 0 0 6 0 0 0 0 0 0 0 9
9 0 0 6 0 2 0 0 0 0 0 0 0 0 2 0 3 0 0 0 6 0 6 0 0 0 0 0 0 9
9 0 5 0 0 2 2 2 0 0 2 0 2 2 0 0 3 0 0 0 0 0 0 0 0 0 0 0 0 9
9 0 0 0 0 0 2 2 2 2 2 2 2 0 0 0 3 0 0 0 0 6 0 6 0 0 0 0 0 9
9 0 5 6 0 0 2 2 2 0 0 0 0 0 0 0 0 3 0 0 0 0 6 0 0 0 0 0 0 9
9 0 0 0 0 0 0 0 0 0 0 0 0 0 0 0 0 0 3 0 0 6 0 6 0 0 0 0 7 9
9 9 9 9 9 9 9 9 9 9 9 9 9 9 9 9 9 9 9 9 9 9 9 9 9 9 9 9 9 9
30 30 20 5
9 9 9 9 9 9 9 9 9 9 9 9 9 9 9 9 9 9 9 9 9 9 9 9 9 9 9 9 9 9
9 8 5 5 5 2 2 5 5 5 5 9 0 0 0 0 0 0 0 0 2 2 2 2 0 0 6 0 8 9
9 0 0 0 2 2 2 2 0 0 0 9 0 0 0 2 2 2 2 2 1 1 1 1 2 2 0 4 0 9
9 0 0 2 2 2 2 2 2 0 0 9 0 0 0 2 1 1 1 1 1 1 1 1 1 1 2 0 6 9
9 0 2 2 2 2 2 2 2 2 0 9 0 0 0 0 2 1 1 1 2 1 1 2 1 1 1 2 0 9
9 0 0 2 2 2 2 2 2 0 0 9 0 0 0 0 2 2 1 2 1 1 2 2 1 1 1 2 0 9
9 0 2 2 2 3 3 2 2 2 0 9 0 0 0 2 0 2 2 2 1 2 0 0 2 2 2 0 2 9
9 2 2 2 2 3 3 2 2 2 2 9 0 0 0 2 0 2 0 0 0 0 0 0 0 0 2 0 2 9
9 0 0 0 0 3 3 0 0 0 0 9 0 0 0 2 0 1 0 0 2 0 0 2 0 0 1 0 2 9
9 0 0 0 0 3 3 0 0 0 0 9 0 0 0 0 2 2 0 0 2 0 0 2 0 0 2 2 0 9
9 9 9 9 9 9 9 9 9 9 9 9 9 9 9 0 2 2 2 5 6 1 1 5 6 2 2 2 0 9
9 0 0 0 0 0 0 0 0 0 0 9 5 6 6 2 0 0 2 2 2 2 2 2 2 2 0 0 2 9
9 0 0 0 0 0 0 0 0 0 0 9 6 5 5 2 0 0 2 0 2 2 2 2 0 2 0 0 2 9
9 0 0 0 0 0 0 0 0 0 0 9 5 1 1 0 2 2 2 4 4 2 2 4 4 2 2 2 0 9
9 0 0 0 2 2 2 2 2 2 2 2 5 1 0 0 0 2 1 2 0 4 4 0 2 1 2 0 0 9
9 0 0 2 1 1 1 1 1 1 1 1 2 0 0 7 0 2 1 1 1 2 2 1 1 1 2 0 0 9
9 0 0 2 1 1 1 2 2 1 1 1 2 0 0 0 1 5 2 2 2 0 0 2 2 2 0 0 0 9
9 0 2 2 1 1 2 2 2 2 1 1 2 2 0 1 5 6 9 0 0 0 0 0 0 0 0 0 0 9
9 0 2 2 2 2 1 1 1 1 2 2 2 2 0 1 6 6 9 0 0 0 0 0 0 0 0 0 0 9
9 2 0 2 0 0 0 0 0 0 0 0 2 0 2 9 9 9 9 9 9 9 9 9 9 9 9 9 9 9
9 2 0 0 0 0 2 0 0 2 0 0 0 0 2 0 0 0 9 5 5 5 5 2 2 5 5 5 5 9
9 0 2 2 0 0 2 0 0 2 0 0 2 2 0 0 0 0 9 0 0 0 2 2 2 2 0 0 0 9
9 0 0 2 2 5 6 1 1 5 6 2 2 0 0 0 0 0 9 0 0 2 2 2 2 2 2 0 0 9
9 0 2 2 0 1 2 2 2 2 1 0 2 2 0 0 0 0 9 0 2 2 2 2 2 2 2 2 0 9
9 2 0 0 2 4 0 1 1 0 4 2 0 0 2 0 0 0 9 0 0 2 2 2 2 2 2 0 0 9
9 2 0 0 2 1 1 4 4 1 1 2 0 0 2 0 0 0 9 0 2 2 2 3 3 2 2 2 0 9
9 6 2 2 2 2 2 2 2 2 2 2 2 2 0 0 0 0 9 2 2 2 2 3 3 2 2 2 2 9
9 0 4 2 1 1 2 2 2 2 1 1 2 0 0 0 0 0 9 0 0 0 0 3 3 0 0 0 0 9
9 8 0 6 2 2 2 0 0 2 2 2 0 0 0 0 0 0 9 0 0 0 0 3 3 0 0 0 8 9
9 9 9 9 9 9 9 9 9 9 9 9 9 9 9 9 9 9 9 9 9 9 9 9 9 9 9 9 9 9
30 30 20 5
9 9 9 9 9 9 9 9 9 9 9 9 9 9 9 9 9 9 9 9 9 9 9 9 9 9 9 9 9 9
9 8 1 2 1 2 1 3 4 0 0 0 0 0 0 3 6 6 6 6 6 6 6 6 6 6 6 6 6 9
9 1 1 3 0 0 0 0 3 0 5 0 0 0 0 0 3 0 0 0 0 0 0 0 0 0 0 0 0 9
9 3 0 0 0 5 0 0 0 3 0 0 6 0 0 4 0 3 0 0 0 0 0 0 0 0 0 0 0 9
9 0 0 0 4 0 5 0 0 0 3 4 0 0 5 0 0 0 3 0 0 0 0 0 0 0 0 0 0 9
9 9 0 0 0 4 0 5 0 0 0 3 0 0 0 0 6 0 0 3 0 0 0 0 0 0 0 0 0 9
9 8 9 0 0 0 6 0 5 0 0 0 3 0 0 0 0 0 5 0 3 0 0 0 0 0 0 0 0 9
9 0 0 9 0 0 0 5 0 6 0 0 0 3 0 4 0 0 0 0 4 3 0 0 0 0 0 0 0 9
9 0 0 0 9 0 0 0 6 0 6 0 0 0 3 0 0 0 0 4 4 3 0 0 0 0 0 0 0 9
9 0 0 0 0 9 0 0 0 5 0 6 0 0 0 3 0 0 4 4 4 3 0 0 0 0 0 0 0 9
9 0 0 0 0 0 9 0 0 0 5 0 6 0 0 0 3 9 9 9 4 3 0 0 0 0 0 0 0 9
9 0 0 0 0 0 0 9 0 0 0 5 0 4 0 0 0 1 0 1 0 9 0 0 0 0 0 0 0 9
9 0 0 0 0 0 0 0 9 0 0 0 6 0 4 0 0 1 0 1 0 9 0 0 0 0 0 0 0 9
9 0 0 0 0 8 0 0 0 9 0 0 0 6 0 4 0 1 0 1 0 9 0 0 0 0 0 0 0 9
9 0 0 0 0 0 0 0 0 0 9 0 0 0 5 0 0 1 0 1 0 9 0 0 0 0 0 0 0 9
9 0 0 0 0 0 0 0 0 0 0 9 9 9 9 9 9 9 0 9 9 9 0 0 0 0 0 0 0 9
9 0 0 0 0 0 0 0 0 3 0 0 0 0 0 0 8 9 0 9 8 0 0 0 0 0 0 0 0 9
9 0 0 0 0 0 0 0 9 6 9 0 0 0 0 0 8 9 0 9 8 0 0 0 0 0 0 0 0 9
9 0 0 0 0 0 0 0 9 6 9 0 0 0 0 0 8 9 0 9 8 0 0 0 0 0 0 0 0 9
9 2 2 2 2 0 0 0 9 6 9 0 0 0 0 0 8 9 0 9 8 0 0 0 0 0 0 0 0 9
9 6 6 6 2 0 0 0 9 6 9 0 0 0 0 0 8 9 0 9 8 0 0 0 0 0 0 0 0 9
9 6 6 6 2 0 0 0 9 6 9 0 0 0 0 0 8 9 0 9 8 0 0 0 0 0 0 0 0 9
9 6 6 6 2 0 0 0 9 0 9 0 0 0 0 0 8 9 0 9 8 6 6 6 6 6 6 6 6 9
9 6 9 9 9 9 9 9 9 2 9 9 9 9 9 9 9 9 3 9 9 9 9 9 9 9 9 9 9 9
9 1 6 6 6 6 6 6 0 0 0 5 5 5 5 5 5 5 0 6 5 5 6 5 5 5 0 0 7 9
9 6 9 9 9 9 9 9 9 2 9 9 9 9 9 9 9 9 3 9 9 9 9 9 9 9 9 9 9 9
9 6 6 6 2 0 0 0 2 4 2 0 0 0 0 0 0 2 4 2 0 0 0 3 6 3 6 6 8 9
9 6 6 6 2 0 0 0 2 0 2 0 0 0 0 0 0 2 0 2 0 0 0 3 6 3 6 6 6 9
9 6 6 6 2 0 0 0 2 0 2 0 0 0 0 0 0 2 0 2 0 0 0 3 6 3 6 6 6 9
9 9 9 9 9 9 9 9 9 9 9 9 9 9 9 9 9 9 9 9 9 9 9 9 9 9 9 9 9 9
55 23 60 5
9 9 9 9 9 9 9 9 9 9 9 9 9 9 9 9 9 9 9 9 9 9 9 9 9 9 9 9 9 9 9 9 9 9 9 9 9 9 9 9 9 9 9 9 9 9 9 9 9 9 9 9 9 9 9
9 9 9 9 9 9 9 9 9 9 9 9 9 9 9 9 9 9 9 9 9 9 9 9 9 9 9 9 9 9 9 9 9 9 9 9 9 9 9 9 9 9 9 9 9 9 9 9 9 9 9 9 9 9 9
9 9 8 9 0 5 0 0 5 0 0 5 0 6 0 9 0 5 0 0 5 0 0 5 0 9 0 5 0 6 0 6 0 5 0 0 5 0 0 5 0 0 5 0 0 5 0 6 0 9 0 5 0 9 9
9 9 4 9 0 9 9 9 9 9 9 9 9 9 4 9 0 9 9 9 9 9 4 9 0 9 9 9 9 9 4 9 9 9 9 9 9 9 9 9 9 9 9 9 9 9 9 9 4 9 0 9 4 9 9
9 9 4 9 0 5 0 9 4 9 0 5 0 5 0 9 4 9 0 5 0 6 0 9 0 5 0 0 5 0 0 9 0 5 0 2 0 0 6 0 5 0 0 5 0 9 4 9 0 9 4 9 0 9 9
9 9 4 9 9 9 5 9 4 9 0 9 9 9 9 9 9 9 4 9 9 9 9 9 9 9 9 9 9 9 9 9 4 9 9 9 4 9 9 9 9 9 4 9 0 9 4 9 0 9 4 9 0 9 9
9 9 0 5 0 6 0 9 4 9 0 5 0 0 5 0 0 9 4 9 0 5 0 6 0 9 0 5 0 9 0 5 0 0 5 0 0 9 0 5 0 0 6 9 0 5 0 9 4 9 0 9 4 9 9
9 9 9 9 9 9 9 9 4 9 9 9 9 9 9 9 4 9 0 9 4 9 9 9 4 9 0 9 4 9 9 9 4 9 9 9 9 9 4 9 9 9 9 9 9 9 4 9 0 9 9 9 4 9 9
9 9 0 0 6 0 5 0 0 2 0 5 0 0 5 0 0 9 0 5 0 6 0 9 0 5 0 9 0 5 0 9 0 5 0 9 0 5 0 9 0 5 0 9 0 5 0 9 0 5 0 9 4 9 9
9 9 4 9 9 9 9 9 9 9 4 9 9 9 9 9 9 9 9 9 9 9 9 9 9 9 9 9 9 9 4 9 9 9 9 9 4 9 9 9 4 9 9 9 4 9 9 9 9 9 4 9 0 9 9
9 9 0 5 0 0 5 0 0 5 0 9 0 5 0 9 0 5 0 0 5 0 0 9 0 5 0 0 5 0 0 9 0 5 0 6 0 9 0 5 0 9 0 5 0 9 0 5 0 6 0 9 4 9 9
9 9 4 9 9 9 9 9 9 9 9 9 4 9 0 9 4 9 0 9 9 9 4 9 0 9 9 9 9 9 9 9 4 9 9 9 9 9 4 9 9 9 4 9 9 9 4 9 9 9 9 9 4 9 9
9 9 0 5 0 0 5 0 0 9 0 5 0 9 4 9 0 9 4 9 0 5 0 9 4 9 0 5 0 9 0 5 0 2 0 5 0 6 0 9 0 5 0 6 0 9 4 9 0 5 0 9 4 9 9
9 9 9 9 9 9 9 9 4 9 9 9 4 9 0 9 4 9 0 9 4 9 9 9 4 9 0 9 9 9 4 9 0 9 9 9 9 9 4 9 0 9 9 9 9 9 4 9 0 9 4 9 0 9 9
9 9 4 9 0 5 0 9 0 5 0 6 0 9 4 9 0 9 4 9 0 5 0 6 0 9 4 9 0 5 0 9 4 9 0 5 0 9 0 5 0 9 4 9 0 5 0 9 4 9 0 5 0 9 9
9 9 4 9 0 9 4 9 9 9 9 9 9 9 4 9 9 9 4 9 9 9 9 9 9 9 4 9 0 9 9 9 4 9 0 9 4 9 0 9 9 9 5 9 4 9 9 9 4 9 9 9 4 9 9
9 9 0 5 0 9 0 5 0 0 5 0 0 9 0 5 0 9 4 9 0 5 0 0 5 0 0 5 0 9 4 9 0 5 0 9 4 9 0 5 0 6 0 9 4 9 0 5 0 2 0 9 4 9 9
9 9 4 9 9 9 9 9 9 9 6 9 9 9 9 9 4 9 0 9 4 9 9 9 9 9 9 9 9 9 4 9 9 9 9 9 4 9 9 9 9 9 4 9 0 9 4 9 9 9 4 9 0 9 9
9 9 4 9 0 0 5 0 0 9 4 9 0 5 0 9 4 9 0 2 0 5 0 6 0 6 0 5 0 9 0 5 0 9 0 5 0 9 0 5 0 9 4 9 0 9 0 5 0 9 4 9 0 9 9
9 9 4 9 0 9 9 9 0 2 0 9 4 9 0 9 4 9 0 9 9 9 9 9 9 9 9 9 4 9 9 9 4 9 0 9 9 9 4 9 0 9 9 9 4 9 9 9 4 9 0 9 1 9 9
9 9 0 5 0 9 0 5 0 9 0 5 0 9 0 5 0 6 0 9 0 5 0 0 5 0 6 0 5 0 0 5 0 9 0 5 0 6 0 9 0 5 0 0 5 0 0 5 0 9 0 1 7 9 9
9 9 9 9 9 9 9 9 9 9 9 9 9 9 9 9 9 9 9 9 9 9 9 9 9 9 9 9 9 9 9 9 9 9 9 9 9 9 9 9 9 9 9 9 9 9 9 9 9 9 9 9 9 9 9
9 9 9 9 9 9 9 9 9 9 9 9 9 9 9 9 9 9 9 9 9 9 9 9 9 9 9 9 9 9 9 9 9 9 9 9 9 9 9 9 9 9 9 9 9 9 9 9 9 9 9 9 9 9 9
17 15 1 16
9 9 9 9 9 9 9 9 9 9 9 9 9 9 9 9 9
9 0 0 0 0 0 0 0 0 9 0 0 0 0 0 9 9
9 0 0 0 0 0 0 0 0 0 0 0 0 0 0 9 9
9 0 0 0 0 0 0 0 0 0 9 0 0 0 0 9 9
9 0 9 0 0 0 0 0 0 0 0 0 0 0 0 9 9
9 9 0 0 0 0 0 0 0 9 0 0 0 0 0 9 9
9 0 0 0 0 0 0 0 0 0 0 0 0 0 9 9 9
9 0 0 0 0 0 0 9 0 0 0 0 0 0 0 0 9
9 0 0 9 0 0 0 0 0 0 0 0 0 0 0 8 9
9 0 0 0 0 0 0 0 0 0 0 0 0 0 9 9 9
9 0 0 0 0 0 0 0 9 0 0 0 0 0 0 9 9
9 0 0 0 0 0 9 0 0 0 9 0 0 0 0 9 9
9 0 0 0 0 0 0 0 0 0 0 0 0 0 0 9 9
9 9 9 9 9 9 9 9 9 9 9 9 9 9 7 9 9
9 9 9 9 9 9 9 9 9 9 9 9 9 9 9 9 9
30 30 20 5
9 9 9 9 9 9 9 9 9 9 9 9 9 9 9 9 9 9 9 9 9 9 9 9 9 9 9 9 9 9
9 8 0 0 0 0 0 0 9 0 0 0 0 0 0 0 0 0 0 0 0 0 0 0 0 0 0 0 0 9
9 9 9 0 0 9 9 9 9 0 0 0 0 0 0 0 0 0 0 0 0 0 0 0 0 0 0 0 0 9
9 0 0 0 9 0 0 0 0 9 9 9 9 9 9 9 9 9 9 9 9 9 9 9 9 9 9 9 9 9
9 0 6 0 9 0 0 0 0 9 0 0 0 0 0 0 0 0 0 0 0 0 0 0 0 0 0 0 0 9
9 5 0 0 9 0 0 0 0 9 0 0 3 0 0 0 6 0 0 5 0 0 0 0 0 0 5 0 0 9
9 0 0 0 9 0 0 0 0 9 0 5 0 0 0 0 0 0 0 0 0 0 0 0 0 0 0 0 0 9
9 0 5 0 9 0 0 0 0 9 0 0 9 9 9 9 9 9 9 9 9 9 9 9 9 0 0 0 0 9
9 6 0 0 9 0 0 0 0 9 0 0 9 0 0 0 0 0 0 0 0 0 0 0 9 0 6 0 0 9
9 0 0 0 9 0 0 0 0 9 0 0 9 0 0 0 0 0 0 0 0 0 0 0 9 0 0 0 0 9
9 0 0 0 9 0 0 0 0 9 0 0 9 0 0 0 0 0 0 0 0 0 0 0 9 0 0 0 0 9
9 0 6 0 9 0 0 0 0 9 0 0 9 0 0 0 0 0 0 0 0 0 0 0 9 0 5 0 0 9
9 5 0 0 9 0 0 0 0 9 0 0 9 0 0 0 0 0 0 0 0 0 0 0 9 0 0 0 0 9
9 0 0 0 9 0 0 0 0 9 2 3 9 0 0 0 0 9 9 9 9 9 9 9 9 0 0 3 3 9
9 0 0 0 9 9 9 9 9 9 0 0 9 0 0 0 0 9 0 0 0 0 0 0 0 0 0 0 0 9
9 6 5 0 9 2 0 0 0 9 0 0 9 0 0 0 0 9 0 0 0 0 0 0 0 0 0 0 0 9
9 0 0 0 9 3 0 0 0 9 0 0 9 0 0 0 0 9 0 0 9 9 9 9 9 9 9 9 9 9
9 0 0 0 9 9 2 3 9 0 0 9 0 0 0 0 9 0 0 9 0 0 0 0 0 0 0 0 0 9
9 0 0 0 9 9 0 0 0 9 0 0 9 0 0 0 0 9 5 0 9 0 0 0 0 0 0 0 0 9
9 0 0 0 9 0 0 0 0 9 0 0 9 0 0 0 0 9 0 0 9 0 0 0 0 0 0 0 0 9
9 5 0 0 9 0 0 0 0 9 1 2 9 0 0 0 0 9 0 0 9 9 9 9 0 0 0 0 0 9
9 0 0 0 9 0 0 0 0 9 0 0 9 0 0 0 0 9 0 0 6 0 0 2 9 0 0 0 0 9
9 0 0 0 9 0 0 0 0 9 0 0 9 0 6 0 0 9 0 0 0 0 0 3 9 0 0 0 0 9
9 0 6 0 9 0 0 0 0 9 0 0 9 0 0 0 9 0 0 9 9 9 9 0 0 0 0 0 0 9
9 0 0 0 9 0 0 0 0 9 0 0 9 0 9 9 9 9 0 0 9 0 0 0 0 0 0 0 0 9
9 0 0 0 9 0 0 0 0 9 0 0 9 0 9 0 0 0 0 0 9 0 0 0 0 0 0 0 0 9
9 0 0 0 9 0 0 0 0 9 0 0 9 0 9 0 6 0 0 0 9 0 0 0 0 0 0 0 0 9
9 0 0 0 9 9 9 9 9 9 0 0 9 9 9 9 0 0 9 9 9 9 9 9 9 9 9 9 9 9
9 0 0 0 0 0 0 0 5 0 0 0 0 0 0 0 9 0 5 0 0 0 0 0 0 0 0 0 7 9
9 9 9 9 9 9 9 9 9 9 9 9 9 9 9 9 9 9 9 9 9 9 9 9 9 9 9 9 9 9