5
20 20 60 10 2
9 9 9 9 9 9 9 9 9 9 9 9 9 9 9 9 9 9 9 9
9 8 9 0 0 0 0 2 0 5 0 0 0 0 0 0 0 0 0 9
9 0 9 0 0 0 0 3 0 0 0 0 0 0 0 0 5 0 0 9
9 0 9 5 0 0 0 2 0 0 6 0 0 0 6 0 0 0 0 9
9 0 9 0 0 0 0 3 0 0 0 0 0 0 0 0 0 0 0 9
9 0 9 0 0 0 0 2 0 5 0 0 5 0 0 0 0 6 0 9
9 0 9 0 5 0 0 3 0 0 0 0 0 0 0 0 0 0 0 9
9 0 9 5 0 0 0 2 3 2 3 2 3 2 3 2 3 2 3 9
9 0 9 0 0 0 0 0 0 0 0 0 0 0 3 2 5 1 1 9
9 0 9 0 0 0 0 6 0 0 0 0 0 0 1 3 3 1 2 9
9 0 9 5 0 0 0 0 0 0 0 0 5 0 3 2 1 2 3 9
9 0 9 0 0 0 0 0 0 0 0 0 0 0 2 3 0 3 1 9
9 0 9 0 0 0 0 0 1 1 1 1 1 1 1 1 1 1 1 9
9 0 9 0 0 0 0 0 1 0 0 4 0 4 0 4 0 4 0 9
9 0 9 0 5 0 0 0 1 0 0 4 0 4 0 4 0 4 0 9
9 0 9 0 0 0 0 0 1 0 0 4 0 4 0 4 0 4 0 9
9 0 0 0 0 0 0 0 1 0 0 4 0 4 0 4 0 4 0 9
9 0 0 0 0 0 0 0 1 0 0 4 0 4 0 4 0 4 0 9
9 0 0 0 0 0 0 0 1 0 0 4 0 4 0 4 0 0 7 9
9 9 9 9 9 9 9 9 9 9 9 9 9 9 9 9 9 9 9 9
30 30 15 0 0
9 9 9 9 9 9 9 9 9 9 9 9 9 9 9 9 9 9 9 9 9 9 9 9 9 9 9 9 9 9
9 8 5 5 5 2 2 5 5 5 5 9 0 0 0 0 0 0 0 0 2 2 2 9 0 0 6 0 8 9
9 0 0 0 2 2 2 2 0 0 0 9 0 0 0 2 2 2 2 2 1 1 1 1 9 9 0 4 0 9
9 0 0 2 2 2 2 2 2 0 0 9 0 0 0 2 1 1 1 1 1 1 1 1 1 1 9 0 6 9
9 0 2 2 2 2 2 2 2 2 0 9 0 0 0 0 2 1 1 1 2 1 1 2 1 1 1 9 0 9
9 0 0 2 2 2 2 2 2 0 0 9 0 0 0 0 2 2 1 2 1 1 2 2 1 1 1 9 0 9
9 0 2 2 2 3 3 2 2 2 0 9 0 0 0 2 0 2 2 2 1 2 0 0 2 2 2 0 2 9
9 2 2 2 2 3 3 2 2 2 2 9 0 0 0 2 0 2 0 0 0 0 0 0 0 0 2 0 2 9
9 0 0 0 0 3 3 0 0 0 0 9 0 0 0 2 0 1 0 0 2 0 0 2 0 0 1 0 2 9
9 0 0 0 0 3 3 0 0 0 0 9 0 0 0 0 2 2 0 0 2 0 0 2 0 0 2 2 0 9
9 9 9 9 9 9 9 9 9 9 9 9 9 9 9 0 2 2 2 5 6 1 1 5 6 2 2 2 0 9
9 0 0 0 0 0 0 0 0 0 0 9 5 6 6 2 0 0 2 2 2 2 2 2 2 2 0 0 2 9
9 0 0 0 0 0 0 0 0 0 0 9 6 5 5 2 0 0 2 0 2 2 2 2 0 2 0 0 2 9
9 0 0 0 0 0 0 0 0 0 0 9 5 1 1 0 2 2 2 4 4 2 2 4 4 2 2 2 0 9
9 0 0 0 2 2 2 2 2 2 2 2 5 1 0 0 0 2 1 2 0 4 4 0 2 1 2 0 0 9
9 0 0 2 1 1 1 1 1 1 1 1 2 0 0 7 0 2 1 1 1 2 2 1 1 1 2 0 0 9
9 0 0 2 1 1 1 2 2 1 1 1 2 0 4 0 1 5 2 2 2 0 0 2 2 2 0 0 0 9
9 0 2 2 1 1 2 2 2 2 1 1 2 2 0 1 5 6 9 0 0 0 0 0 0 0 0 0 0 9
9 0 2 2 2 2 1 1 1 1 2 2 2 2 0 1 6 6 9 0 0 0 0 0 0 0 0 0 0 9
9 2 0 2 0 0 0 0 0 0 0 0 2 0 2 9 9 9 9 9 9 9 9 9 9 9 9 9 9 9
9 2 0 0 0 0 2 0 0 2 0 0 0 0 2 0 0 0 9 5 5 5 5 2 2 5 5 5 5 9
9 0 2 2 0 0 2 0 0 2 0 0 2 2 0 0 0 0 9 0 0 0 2 2 2 2 0 0 0 9
9 0 0 2 2 5 6 1 1 5 6 2 2 0 4 0 0 0 9 0 0 2 2 2 2 2 2 0 0 9
9 0 2 2 0 1 2 2 2 2 1 0 2 2 0 0 0 0 9 0 2 2 2 2 2 2 2 2 0 9
9 2 0 0 2 4 0 1 1 0 4 2 0 0 2 0 5 0 9 0 0 2 2 2 2 2 2 0 0 9
9 2 0 0 2 1 1 4 4 1 1 2 0 0 2 0 0 0 9 0 2 2 2 3 3 2 2 2 0 9
9 6 9 2 2 2 2 2 2 2 2 2 2 2 0 0 0 0 9 2 2 2 2 3 3 2 2 2 2 9
9 0 4 9 1 1 2 2 2 2 1 1 2 0 0 6 0 0 9 0 0 0 0 3 3 0 0 0 0 9
9 8 0 6 9 2 2 0 6 2 2 2 0 0 0 0 0 0 9 0 0 0 0 3 3 0 0 0 8 9
9 9 9 9 9 9 9 9 9 9 9 9 9 9 9 9 9 9 9 9 9 9 9 9 9 9 9 9 9 9
18 15 1 16 0
9 9 9 9 9 9 9 9 9 9 9 9 9 9 9 9 9 9
9 0 0 0 0 0 0 0 0 9 0 0 0 0 0 9 9 9
9 0 0 0 0 0 0 0 0 0 0 0 0 0 0 9 9 9
9 0 0 0 0 0 0 0 0 0 9 0 0 0 0 9 9 9
9 0 9 0 0 0 0 0 0 0 0 0 0 0 0 9 9 9
9 9 0 0 0 0 0 0 0 9 0 0 0 0 0 9 9 9
9 0 0 0 0 0 0 0 0 0 0 0 0 0 9 9 9 9
9 0 0 0 0 0 0 9 0 0 0 0 0 0 0 0 9 9
9 0 0 9 0 0 0 0 0 0 0 0 0 0 0 3 8 9
9 0 0 0 0 0 0 0 0 0 0 0 0 0 9 9 9 9
9 0 0 0 0 0 0 0 9 0 0 0 0 0 0 9 9 9
9 0 0 0 0 0 9 0 0 0 9 0 0 0 0 9 9 9
9 0 0 0 0 0 0 0 0 0 0 0 0 0 0 9 9 9
9 9 9 9 9 9 9 9 9 9 9 9 9 9 7 9 9 9
9 9 9 9 9 9 9 9 9 9 9 9 9 9 9 9 9 9
30 30 25 2 2
9 9 9 9 9 9 9 9 9 9 9 9 9 9 9 9 9 9 9 9 9 9 9 9 9 9 9 9 9 9
9 0 0 0 0 0 0 5 0 6 0 4 0 4 5 6 4 5 6 4 5 6 9 0 9 9 9 9 0 9
9 0 5 0 0 0 0 0 0 2 2 2 2 2 2 2 0 0 0 5 6 5 6 5 6 5 6 5 6 9
9 0 5 0 0 0 0 2 2 2 2 2 2 0 0 0 2 2 0 0 0 0 0 9 0 0 0 0 0 9
9 0 6 0 0 0 2 0 0 5 6 0 0 2 2 0 0 0 2 0 0 0 0 9 0 0 0 0 0 9
9 0 5 0 0 2 8 2 2 2 2 0 5 0 6 2 0 0 0 2 0 0 0 9 0 0 0 0 0 9
9 0 6 0 0 2 2 0 0 5 0 2 2 0 0 0 2 0 0 2 0 0 0 4 0 0 0 0 0 9
9 0 5 0 0 0 2 0 0 0 0 0 0 2 5 6 0 2 0 2 0 0 0 9 0 0 0 0 0 9
9 0 6 0 0 2 0 2 2 2 0 0 0 0 2 0 0 2 0 2 0 0 0 9 0 0 0 0 0 9
9 0 5 0 0 2 2 4 4 4 2 0 9 0 2 2 0 0 2 2 2 0 0 9 0 0 0 0 0 9
9 0 5 0 0 2 2 4 4 4 2 0 0 0 2 0 2 0 2 4 4 2 0 0 0 0 0 0 0 9
9 0 5 0 2 0 2 4 4 4 2 0 0 2 5 6 2 0 2 4 4 2 0 0 0 0 0 0 0 9
9 0 6 2 0 0 0 2 2 2 0 2 2 0 0 0 2 2 0 2 2 0 0 0 0 0 0 0 0 9
9 0 5 2 0 0 0 0 0 0 0 0 0 0 2 2 0 2 0 0 0 0 0 0 0 0 0 0 0 9
9 0 2 2 0 0 0 0 0 0 0 0 0 0 2 0 2 2 0 0 0 0 0 0 0 0 0 0 0 9
9 2 0 0 2 0 0 0 0 0 0 0 0 2 0 2 0 0 2 0 0 0 0 0 9 9 9 9 0 9
9 2 0 0 2 2 0 0 0 0 2 2 2 0 2 0 5 0 0 2 0 0 0 9 0 0 0 0 9 9
9 0 2 2 0 2 2 2 2 2 0 0 2 2 0 0 2 2 2 2 2 0 9 0 0 0 0 0 0 9
9 0 0 2 2 0 2 0 0 2 0 5 0 0 5 6 2 2 3 3 3 9 0 0 6 0 6 0 0 9
9 0 6 0 2 0 0 2 2 0 0 0 0 0 0 2 2 3 0 0 1 0 0 0 0 6 0 0 0 9
9 0 0 2 0 2 0 0 2 2 2 2 0 0 0 2 0 3 3 1 2 0 0 0 6 0 6 0 0 9
9 0 0 2 2 0 2 2 0 5 5 6 2 2 0 2 0 2 9 0 0 0 0 0 0 0 0 0 0 9
9 0 5 0 2 2 0 0 2 2 2 2 0 0 2 2 0 9 0 0 6 0 6 0 0 0 0 0 0 9
9 0 0 0 2 0 2 2 0 0 2 2 2 2 0 2 9 0 0 0 0 6 0 0 0 0 0 0 0 9
9 0 0 6 0 2 0 0 0 0 0 0 0 0 2 0 9 0 0 0 6 0 6 0 0 0 0 0 0 9
9 0 5 0 0 2 2 2 0 0 2 0 2 2 0 0 9 0 0 0 0 0 0 0 0 0 0 0 0 9
9 0 0 0 0 0 2 2 2 2 2 2 2 0 0 0 9 0 0 0 0 6 0 6 0 0 0 0 0 9
9 0 5 6 0 0 2 2 2 0 0 0 0 0 0 0 0 9 0 0 0 0 6 0 0 0 0 0 4 9
9 0 0 0 0 0 0 0 0 0 0 0 0 0 0 0 0 0 9 0 0 6 0 6 0 0 0 4 7 9
9 9 9 9 9 9 9 9 9 9 9 9 9 9 9 9 9 9 9 9 9 9 9 9 9 9 9 9 9 9
30 30 20 1 0
9 9 9 9 9 9 9 9 9 9 9 9 9 9 9 9 9 9 9 9 9 9 9 9 9 9 9 9 9 9
9 8 0 1 5 1 0 0 0 0 0 0 0 0 0 0 0 0 0 0 0 0 0 0 0 0 0 0 0 9
9 0 0 0 1 5 1 0 0 0 0 0 0 0 0 0 0 0 0 0 0 0 0 0 0 0 0 0 0 9
9 1 0 0 0 1 5 1 0 0 0 0 0 0 0 0 0 0 0 0 0 0 0 0 0 0 0 0 0 9
9 5 1 0 0 0 1 5 1 0 0 0 0 0 0 0 0 0 0 0 0 0 0 0 0 0 0 0 0 9
9 1 5 1 0 4 0 1 5 1 0 0 0 0 0 0 0 0 0 0 0 0 0 0 0 0 0 0 0 9
9 0 1 5 1 0 0 0 1 5 1 0 0 0 0 0 0 0 0 0 0 0 0 0 0 0 0 0 0 9
9 0 0 1 5 1 0 0 0 1 5 1 0 0 0 0 0 0 0 0 0 0 0 0 0 0 0 0 0 9
9 0 0 0 1 5 1 0 0 0 1 5 1 0 0 0 0 0 0 0 0 0 0 0 0 0 0 0 0 9
9 0 0 0 0 1 5 1 0 4 0 1 5 1 0 0 0 0 0 0 0 0 0 0 0 0 0 0 0 9
9 0 0 0 0 0 1 5 1 0 0 0 1 5 1 0 0 0 0 0 0 0 0 0 0 0 0 0 0 9
9 0 0 0 0 0 0 1 5 1 0 0 0 1 5 1 0 0 0 0 0 0 0 0 0 0 0 0 0 9
9 0 0 0 0 0 0 0 1 5 1 0 0 0 1 5 1 0 0 0 0 0 0 0 0 0 0 0 0 9
9 0 0 0 0 0 0 0 0 1 5 1 0 4 0 1 5 1 0 0 0 0 0 0 0 0 0 0 0 9
9 0 0 0 0 0 0 0 0 0 1 5 1 0 0 0 1 5 1 0 0 0 0 0 0 0 0 0 0 9
9 0 0 0 0 0 0 0 0 0 0 1 5 1 0 0 0 1 5 1 0 0 0 0 0 0 0 0 0 9
9 0 0 0 0 0 0 0 0 0 0 0 1 5 1 0 0 0 1 5 1 0 0 0 0 0 0 0 0 9
9 0 0 0 0 0 0 0 0 0 0 0 0 1 5 1 0 4 0 1 5 1 0 0 0 0 0 0 0 9
9 0 0 0 0 0 0 0 0 0 0 0 0 0 1 5 1 0 0 0 1 5 1 0 0 0 0 0 0 9
9 0 0 0 0 0 0 0 0 0 0 0 0 0 0 1 5 1 0 0 0 1 5 1 1 1 1 1 1 9
9 0 0 0 0 0 0 0 0 0 0 0 0 0 0 0 1 5 1 0 0 0 1 5 1 5 5 5 5 9
9 0 0 0 0 0 0 0 0 0 0 0 0 0 0 0 0 1 5 1 0 4 0 1 5 5 5 5 5 9
9 0 0 0 0 0 0 0 0 0 0 0 0 0 0 0 0 0 1 5 1 0 0 0 1 5 5 5 6 9
9 0 0 0 0 0 0 0 0 0 0 0 0 0 0 0 0 0 0 1 5 1 0 0 0 1 5 6 5 9
9 0 0 0 0 0 0 0 0 0 0 0 0 0 0 0 0 0 0 1 1 5 1 0 0 0 1 5 6 9
9 0 0 0 0 0 0 0 0 0 0 0 0 0 0 0 0 0 0 1 5 5 5 1 0 4 0 1 0 9
9 0 0 0 0 0 0 0 0 0 0 0 0 0 0 0 0 0 0 1 5 5 5 5 1 0 0 0 0 9
9 0 0 0 0 0 0 0 0 0 0 0 0 0 0 0 0 0 0 1 5 5 5 5 6 1 0 0 0 9
9 0 0 0 0 0 0 0 0 0 0 0 0 0 0 0 0 0 0 1 5 5 6 5 6 5 0 0 7 9
9 9 9 9 9 9 9 9 9 9 9 9 9 9 9 9 9 9 9 9 9 9 9 9 9 9 9 9 9 9